R 1440 810
SO ./images/stars.xpm
WE ./images/stars.xpm
NO ./images/stars.xpm
EA ./images/stars.xpm

S ./images/ghost.xpm

F 156, 204, 156
C 195, 200, 255

11111
12S21
12021
12021
12021
12021
12021
12021
12021
12021
12021
12021
12021
12021
12021
12021
12021
12021
12021
12021
12021
12021
11111