R 1440 810
SO ./images/stars.xpm
WE ./images/stars.xpm
NO ./images/stars.xpm
EA ./images/stars.xpm

S ./images/ghost.xpm

F 156, 204, 156
C 195, 200, 255

11111111111111111111111111
12222222222222222222222221
12222222222222222222222221
12222222222222222222222221
12222222222222222222222221
12222222222222222222222221
122222222222N2222222222221
12222222222222222222222221
12222222222222222222222221
12222222222222222222222221
12222222222222222222222221
12222222222222222222222221
11111111111111111111111111