R 1920 1080
NO ./path_to_the_north_texture
SO ./path_to_the_south_texture
WE ./path_to_the_west_texture
EA ./path_to_the_east_texture

S ./path_to_the_sprite_texture

F 252, 244, 163
C 205, 240, 255

1111
1001
100111111111111111
100020000000000001
10000000000000N001
111111111111111001
              1001
              1111