R 1440 810
SO ./images/bright_green_wall.xpm
WE ./images/dark_green_wall.xpm
NO ./images/sunny_green_wall.xpm
EA ./images/shadow_green_wall.xpm

S ./images/barrel.xpm

F 156, 204, 156
C 195, 200, 255

1111
1001
100111111111111111
100020000000000001
10000000000000N001
111111111111111001
              1001
              1111