R 1440 810
SO ./images/bright_green_wall.xpm
WE ./images/dark_green_wall.xpm
NO ./images/sunny_green_wall.xpm
EA ./images/shadow_green_wall.xpm

S ./images/tree.xpm

F 156, 204, 156
C 195, 200, 255

111111              11111
10S0211             12021
12000211            10201
112000211           11111
 112000211
  112000211
   112000211
    112000211
     112000211
      112000211
       112000211
        112000211
         112000211
          112000211
           112000211
            112000211
             112000211
              112000211
11111          112000211
10201           11200021
12021            1122221
11111             111111