R 1440 810
SO ./images/bright_green_wall.xpm
WE ./images/dark_green_wall.xpm
NO ./images/sunny_green_wall.xpm
EA ./images/shadow_green_wall.xpm

S ./images/barrel.xpm

F 156, 204, 156
C 195, 200, 255

11111               11111
10W011              12021
1100011             10201
 1100011            11111
  1100011
   1100011
    1100011
     1100011
      1100011
       1100011
        1100011
         1100011
          1100011
           1100011
            1100011
             1100011
              1100011
               1100011
11111           1100011
10201            1100011
12021             110201
11111              11111