R 1440 810
SO ./images/bright_green_wall.xpm
WE ./images/dark_green_wall.xpm
NO ./images/sunny_green_wall.xpm
EA ./images/shadow_green_wall.xpm

S ./images/tree.xpm

F 156, 204, 156
C 195, 200, 255

11111               11111
10S021              12021
1200021             10201
 1200021            11111
  1200021
   1200021
    1200021
     1200021
      1200021
       1200021
        1200021
         1200021
          1200021
           1200021
            1200021
             1200021
              1200021
               1200021
11111           1200021
10201            1200021
12021             122221
11111              11111