R 1440 810
SO ./images/bright_green_wall.xpm
WE ./images/dark_green_wall.xpm
NO ./images/sunny_green_wall.xpm
EA ./images/shadow_green_wall.xpm

S ./images/barrel.xpm

F 156, 204, 156
C 195, 200, 255

11111111111
10000000001
10000000001
10000000001
10000000001
10000000001
10000000001
10000000001
10000000001
10000000001
10000000001
10000000001
10000000001
10000000001
10000000001
10000000001
10000000001
10000000001
10000000001
10000000001
10000000001
10000000001
10000000001
10000000001
10000000001
10000000001
10000000001
10000000001
10000000001
10000000001
10000000001
10000000001
10000000001
10000000001
10000000001
10000000001
10000000001
10000000001
10000000001
10000000001
10000000001
10000000001
10000000001
10000000001
10000000001
10000000001
10000000001
10000000001
10000000001
10000000001
10000000001
10000000001
10000000001
10000000001
10000000001
10000000001
10000000001
10000000001
10000000001
10000000001
10000000001
10000000001
10000000001
10000000001
10000000001
10000000001
10000000001
10000000001
10000000001
10000000001
10000000001
10000000001
10000000001
10000000001
10000000001
10000000001
10000000001
10000000001
10000000001
10000000001
10000000001
10000000001
10000000001
10000000001
10000000001
10000000001
10000000001
10000000001
10000000001
10000000001
10000000001
10000000001
10000000001
10000000001
10000000001
10000000001
10000000001
10000000001
10000000001
10000000001
10000000001
10000000001
10000000001
10000000001
10000000001
10000000001
10000000001
10000000001
10000000001
10000000001
10000000001
10000000001
10000000001
10000000001
10000000001
10000000001
10000000001
10000000001
10000000001
10000000001
10000000001
10000000001
10000000001
10000000001
10000000001
10000000001
10000000001
10000000001
10000000001
10000000001
10000000001
10000000001
10000000001
10000000001
10000000001
10000000001
10000000001
10000000001
10000000001
10000000001
10000000001
10000000001
10000000001
10000000001
10000000001
10000000001
10000000001
10000000001
10000000001
10000000001
10000000001
10000000001
10000000001
10000000001
10000000001
10000000001
10000000001
10000000001
10000000001
10000000001
10000000001
10000000001
10000000001
10000000001
10000000001
10000000001
10000000001
10000000001
10000000001
10000000001
10000000001
10000000001
10000000001
10000000001
10000000001
10000000001
10000000001
10000000001
10000000001
10000000001
10000000001
10000000001
10000000001
10000000001
10000000001
10000000001
10000000001
10000000001
10000000001
10000000001
10000000001
10000000001
10000000001
10000000001
10000000001
10000000001
10000000001
10000000001
10000000001
10000000001
10000000001
10000000001
10000000001
10000000001
10000000001
10000000001
10000000001
10000000001
10000000001
10000000001
10000000001
10000000001
10000000001
10000000001
10000000001
10000000001
10000000001
10000000001
10000000001
10000000001
10000000001
10000000001
10000000001
10000000001
10000000001
10000000001
10000000001
10000000001
10000000001
10000000001
10000000001
10000000001
10000000001
10000000001
10000000001
10000000001
10000000001
10000000001
10000000001
10000000001
10000000001
10000000001
10000000001
10000000001
10000000001
10000000001
10000000001
10000000001
10000000001
10000000001
10000000001
10000000001
10000000001
10000000001
10000000001
10000000001
10000000001
10000000001
10000000001
10000000001
10000000001
10000000001
10000000001
10000000001
10000000001
10000000001
10000000001
10000000001
10000000001
10000000001
10000000001
10000000001
10000000001
10000000001
10000000001
10000000001
10000000001
10000000001
10000000001
10000000001
10000000001
10000000001
10000000001
10000000001
10000000001
10000000001
10000000001
10000000001
10000000001
10000000001
10000000001
10000000001
10000000001
10000000001
10000000001
10000000001
10000000001
10000000001
10000000001
10000000001
10000000001
10000000001
10000000001
10000000001
10000000001
10000000001
10000000001
10000000001
10000000001
10000000001
10000000001
10000000001
10000000001
10000000001
10000000001
10000000001
10000000001
10000000001
10000000001
10000000001
10000000001
10000000001
10000000001
10000000001
10000000001
10000000001
10000000001
10000000001
10000000001
10000000001
10000000001
10000000001
10000000001
10000000001
10000000001
10000000001
10000000001
10000000001
10000000001
10000000001
10000000001
10000000001
10000000001
10000000001
10000000001
10000000001
10000000001
10000000001
10000000001
10000000001
10000000001
10000000001
10000000001
10000000001
10000000001
10000000001
10000000001
10000000001
10000000001
10000000001
10000000001
10000000001
10000000001
10000000001
10000000001
10000000001
10000000001
10000000001
10000000001
10000000001
10000000001
10000000001
10000000001
10000000001
10000000001
10000000001
10000000001
10000000001
10000000001
10000000001
10000000001
10000000001
10000000001
10000000001
10000000001
10000000001
10000000001
10000000001
10000000001
10000000001
10000000001
10000000001
10000000001
10000000001
10000000001
10000000001
10000000001
10000000001
10000000001
10000000001
10000000001
10000000001
10000000001
10000000001
10000000001
10000000001
10000000001
10000000001
10000000001
10000000001
10000000001
10000000001
10000000001
10000000001
10000000001
10000000001
10000000001
10000000001
10000000001
10000000001
10000000001
10000000001
10000000001
10000000001
10000000001
10000000001
10000000001
10000000001
10000000001
10000000001
10000000001
10000000001
10000000001
10000000001
10000000001
10000000001
10000000001
10000000001
10000000001
10000000001
10000000001
10000000001
10000000001
10000000001
10000000001
10000000001
10000000001
10000000001
10000000001
10000000001
10000000001
10000000001
10000000001
10000000001
10000000001
10000000001
10000000001
10000000001
10000000001
10000000001
10000000001
10000000001
10000000001
10000000001
10000000001
10000000001
10000000001
10000000001
10000000001
10000000001
10000000001
10000000001
10000000001
10000000001
10000000001
10000000001
10000000001
10000000001
10000000001
10000000001
10000000001
10000000001
10000000001
10000000001
10000000001
10000000001
10000000001
10000000001
10000000001
10000000001
10000000001
10000000001
10000000001
10000000001
10000000001
10000000001
10000000001
10000000001
10000000001
10000000001
10000000001
10000000001
10000000001
10000000001
10000000001
10000000001
10000000001
10000000001
10000000001
10000000001
10000000001
10000000001
10000000001
10000000001
10000000001
10000000001
10000000001
10000000001
10000000001
10000000001
10000000001
10000000001
10000000001
10000000001
10000000001
10000000001
10000000001
10000000001
10000000001
10000000001
10000000001
10000000001
10000000001
10000000001
10000000001
10000000001
10000000001
10000000001
10000000001
10000000001
10000000001
10000000001
10000000001
10000000001
10000000001
10000000001
10000000001
10000000001
10000000001
10000000001
10000000001
10000000001
10000000001
10000000001
10000000001
10000000001
10000000001
10000000001
10000000001
10000000001
10000000001
10000000001
10000000001
10000000001
10000000001
10000000001
10000000001
10000000001
10000000001
10000000001
10000000001
10000000001
10000000001
10000000001
10000000001
10000000001
10000000001
10000000001
10000000001
10000000001
10000000001
10000000001
10000000001
10000000001
10000000001
10000000001
10000000001
10000000001
10000000001
10000000001
10000000001
10000000001
10000000001
10000000001
10000000001
10000000001
10000000001
10000000001
10000000001
10000000001
10000000001
10000000001
10000000001
10000000001
10000000001
10000000001
10000000001
10000000001
10000000001
10000000001
10000000001
10000000001
10000000001
10000000001
10000000001
10000000001
10000000001
10000000001
10000000001
10000000001
10000000001
10000000001
10000000001
10000000001
10000000001
10000000001
10000000001
10000000001
10000000001
10000000001
10000000001
10000000001
10000000001
10000000001
10000000001
10000000001
10000000001
10000000001
10000000001
10000000001
10000000001
10000000001
10000000001
10000000001
10000000001
10000000001
10000000001
10000000001
10000000001
10000000001
10000000001
10000000001
10000000001
10000000001
10000000001
10000000001
10000000001
10000000001
10000000001
10000000001
10000000001
10000000001
10000000001
10000000001
10000000001
10000000001
10000000001
10000000001
10000000001
10000000001
10000000001
10000000001
10000000001
10000000001
10000000001
10000000001
10000000001
10000000001
10000000001
10000000001
10000000001
10000000001
10000000001
10000000001
10000000001
10000000001
10000000001
10000000001
10000000001
10000000001
10000000001
10000000001
10000000001
10000000001
10000000001
10000000001
10000000001
10000000001
10000000001
10000000001
10000000001
10000000001
10000000001
10000000001
10000000001
10000000001
10000000001
10000000001
10000000001
10000000001
10000000001
10000000001
10000000001
10000000001
10000000001
10000000001
10000000001
10000000001
10000000001
10000N00001
10000000001
11111111111