R 1920 1080
NO ./path_to_the_north_texture
SO ./path_to_the_south_texture
WE ./path_to_the_west_texture
EA ./path_to_the_east_texture

S ./path_to_the_sprite_texture

F 252, 244, 163
C 205, 240, 255

111111111111111111111111111111111111111111
100000000000000000000000000000000000000001
1000000000000000000000000000000000S0000001
100000000000000000000000000000000000000001
100000000000000000000000000000000000000001
100000000000000001110000000000000000000001
100000000000000001110000000000000000000001
100000000000000001110000000000000000000001
100000000000000001110000000000000000000001
100000000000000000000000000000000000000001
100000000000000000000000000000000000000001
100000000000000000000000000000000000000001
100000000000000000000000000000000000000001
100000000000000000000000000000000000000001
100000000000000000000000000000000000000001
100000000000000000000000000000000000000001
100000000000000000000000000000000000000001
100000001111110000000000000000001111110001
100110001111110001111000000000001111110001
100110001111110001111000000000001111110001
100110001111110001111000000000001111110001
100000000000000000000000000000000000000001
100000000000000000000000000000000000000001
100000000000000000000000000000000000000001
100000000000000000000000000000000000000001
100000000000000000000000000000000000000001
100000000000000000000000000000000000000001
100000000000000000000000000000000000000001
100000000000000000000000000000000000000001
100000000000000000000000000000000000000001
100000000000000000000000000000000000000001
111111111111111111111111111111111111111111