R 1920 1080
NO ./images/brick_wall.xpm
SO ./images/colorstone.xpm
WE ./images/greystone.xpm
EA ./images/wood.xpm

S ./images/barrel.xpm

F 252, 244, 163
C 205, 240, 255

1111111 1111111 1111111 1111111
1200021 1200111 1020201 1111111
1110111 1110111 1010101 1110111
1110111 1110111 1000001 1102011
1200021 1110021 1010101 1010101
1110111111101111100000111100011
1110111112001111111011111110111
1110111111101111111011111110111
12E0000000000000000000000000021
1110111111101111111011111110111
1110111112001111111011111110111
1110111111101111100000111100011
1200021 1110021 1010101 1010101
1110111 1110111 1000001 1102011
1110111 1110111 1010101 1110111
1200021 1200111 1020201 1111111
1111111 1111111 1111111 1111111