R 1440 810
SO ./images/bright_green_wall.xpm
WE ./images/dark_green_wall.xpm
NO ./images/sunny_green_wall.xpm
EA ./images/shadow_green_wall.xpm

S ./images/tree.xpm

F 156, 204, 156
C 195, 200, 255

1111111 1111111 1111111 1111111
1200021 1200111 1020201 1101011
1110111 1110111 1010101 1010101
1110111 1110111 1000001 1102011
1200021 1110021 1010101 1010101
1110111111101111100000111100011
1110111112001111111011111110111
1110525211101111111011111110111
12E0300000004000000000000000021
1110525211101111111011111110111
1110111112001111111011111110111
1110111111101111100000111100011
1200021 1110021 1010101 1010101
1110111 1110111 1000001 1102011
1110111 1110111 1010101 1010101
1200021 1200111 1020201 1101011
1111111 1111111 1111111 1111111