R 1440 810
SO ./images/bright_green_wall.xpm
WE ./images/dark_green_wall.xpm
NO ./images/sunny_green_wall.xpm
EA ./images/shadow_green_wall.xpm

S ./images/tree.xpm

F 156, 204, 156
C 195, 200, 255

1111111111111111111111111111111
1100200020002000200011222222211
1100000000000000000011220002211
1100002000200020002011220502211
1202111111111111111311220002211
1000400000000001111011114441111
1202111111111101111411200000211
1111111222222101111011000000011
1111111222222101111011003230011
1111122222222101111011000000011
1110000000000001111411000000011
1100022222222111111411200500211
1100011222222111111411000000011
1100011222222111112021000000011
1100011111111111111011300200311
1100011111100000011011000000011
1100011111100000000011000000011
110N011111100000011111200500211
1111111111100011111111000000011
1122222111100011120211300200311
1120002111144411100011000000011
1120500444444444405011000000011
1120002111144411100011200500211
1122222111120211120211000000011
1111111111105011111111000000011
1111111111100011111111000200011
1111111111100000000000000000011
1111111111111111111111111111111